"filename", "language", "C", "C++", "comment", "blank", "total"
"y:\Workplace_Keil\小车\遥控小车\STM32F10x_Car_In_Project_LYB_V2.3\BSP\inc\bsp_exti.h", "C++", 0, 99, 51, 70, 220
"y:\Workplace_Keil\小车\遥控小车\STM32F10x_Car_In_Project_LYB_V2.3\BSP\inc\bsp_iwdg.h", "C++", 0, 26, 35, 34, 95
"y:\Workplace_Keil\小车\遥控小车\STM32F10x_Car_In_Project_LYB_V2.3\BSP\inc\bsp_led.h", "C++", 0, 74, 64, 55, 193
"y:\Workplace_Keil\小车\遥控小车\STM32F10x_Car_In_Project_LYB_V2.3\BSP\inc\bsp_lora.h", "C++", 0, 117, 70, 66, 253
"y:\Workplace_Keil\小车\遥控小车\STM32F10x_Car_In_Project_LYB_V2.3\BSP\inc\bsp_motor.h", "C++", 0, 100, 58, 70, 228
"y:\Workplace_Keil\小车\遥控小车\STM32F10x_Car_In_Project_LYB_V2.3\BSP\inc\bsp_oled.h", "C++", 0, 73, 75, 57, 205
"y:\Workplace_Keil\小车\遥控小车\STM32F10x_Car_In_Project_LYB_V2.3\BSP\inc\bsp_pwm.h", "C++", 0, 142, 53, 73, 268
"y:\Workplace_Keil\小车\遥控小车\STM32F10x_Car_In_Project_LYB_V2.3\BSP\inc\bsp_robotarm.h", "C++", 0, 63, 54, 43, 160
"y:\Workplace_Keil\小车\遥控小车\STM32F10x_Car_In_Project_LYB_V2.3\BSP\inc\bsp_scom.h", "C++", 0, 140, 94, 75, 309
"y:\Workplace_Keil\小车\遥控小车\STM32F10x_Car_In_Project_LYB_V2.3\BSP\inc\bsp_ultrasonic.h", "C++", 0, 73, 63, 73, 209
"y:\Workplace_Keil\小车\遥控小车\STM32F10x_Car_In_Project_LYB_V2.3\BSP\src\bsp_exti.c", "C", 173, 0, 56, 73, 302
"y:\Workplace_Keil\小车\遥控小车\STM32F10x_Car_In_Project_LYB_V2.3\BSP\src\bsp_iwdg.c", "C", 28, 0, 34, 39, 101
"y:\Workplace_Keil\小车\遥控小车\STM32F10x_Car_In_Project_LYB_V2.3\BSP\src\bsp_led.c", "C", 241, 0, 93, 104, 438
"y:\Workplace_Keil\小车\遥控小车\STM32F10x_Car_In_Project_LYB_V2.3\BSP\src\bsp_led_it.c", "C", 31, 0, 20, 15, 66
"y:\Workplace_Keil\小车\遥控小车\STM32F10x_Car_In_Project_LYB_V2.3\BSP\src\bsp_lora.c", "C", 282, 0, 88, 103, 473
"y:\Workplace_Keil\小车\遥控小车\STM32F10x_Car_In_Project_LYB_V2.3\BSP\src\bsp_motor.c", "C", 361, 0, 85, 136, 582
"y:\Workplace_Keil\小车\遥控小车\STM32F10x_Car_In_Project_LYB_V2.3\BSP\src\bsp_oled.c", "C", 291, 0, 97, 111, 499
"y:\Workplace_Keil\小车\遥控小车\STM32F10x_Car_In_Project_LYB_V2.3\BSP\src\bsp_pwm.c", "C", 257, 0, 60, 66, 383
"y:\Workplace_Keil\小车\遥控小车\STM32F10x_Car_In_Project_LYB_V2.3\BSP\src\bsp_robotarm.c", "C", 137, 0, 57, 71, 265
"y:\Workplace_Keil\小车\遥控小车\STM32F10x_Car_In_Project_LYB_V2.3\BSP\src\bsp_scom.c", "C", 542, 0, 156, 181, 879
"y:\Workplace_Keil\小车\遥控小车\STM32F10x_Car_In_Project_LYB_V2.3\BSP\src\bsp_scom_it.c", "C", 73, 0, 40, 44, 157
"y:\Workplace_Keil\小车\遥控小车\STM32F10x_Car_In_Project_LYB_V2.3\BSP\src\bsp_ultrasonic.c", "C", 208, 0, 90, 110, 408
"y:\Workplace_Keil\小车\遥控小车\STM32F10x_Car_In_Project_LYB_V2.3\BSP\src\bsp_ultrasonic_it.c", "C", 43, 0, 25, 20, 88
"Total", "-", 2667, 907, 1518, 1689, 6781